************************************************************
*...........*.............*.......*....*......*...........**
******.*.**.*.***********.*.*****.*.**.*.****.*.************
*....*.*.**...................................*.**......**.*
*......*.**.*.**********.************.**.******.....**.***.*
*....*.*.**.*.****...***.....********....******.**..**.....*
*....*.*.**.*.****.*********......*****.**********.*********
******.*.**..............********.*****.***.**.....*********
*.........*.*.**.***.***..........*****.***.**.*.***....****
***********.*.**.....*********.********.....**.*.....**...**
*.............*************....*********.**....*************
*******.********.******..**.*******......****...........*..*
*.......********.***....***.....***.**.****************...**
*.*******............**********.**..**........*****.....*..*
*********.************..*******.**.**********.****..**..*.**
*.**.*.....................................**.****.****...**
*....*.**.***********.****..*******.****.****.****...*******
******.**.......*.....****..*******.****...*..******.*******
*......**...***...**....**..*****...******...******..*******
************************************************************