************************************************************
*           *             *       *    *      *           **
****** * ** * *********** * ***** * ** * **** * ************
*    * * **                                   * **      ** *
*      * ** * ********** ************ ** ******     ** *** *
*    * * ** * ****   ***     ********    ****** **  **     *
*    * * ** * **** *********      ***** ********** *********
****** * **              ******** ***** *** **     *********
*         * * ** *** ***          ***** *** ** * ***    ****
*********** * **     ********* ********     ** *     **   **
*             *************    ********* **    *************
******* ******** ******  ** *******      ****           *  *
*       ******** ***    ***     *** ** ****************   **
* *******            ********** **  **        *****     *  *
********* ************  ******* ** ********** ****  **  * **
* ** *                                     ** **** ****   **
*    * ** *********** ****  ******* **** **** ****   *******
****** **       *     ****  ******* ****   *  ****** *******
*      **   ***   **    **  *****   ******   ******  *******
************************************************************