****************************************
*   *    ****    *** ********    *** ***
* *** ** * ** ** ***          **       *
*     **   ***       ***** ** ***** ****
******** ******* *** ***** **    ** ** *
********    **** ***    ***** ** *  ** *
*** ******* **** *** ** ***** ** ** ** *
***    **** **** *** ** ***** **       *
*** ** ****      *** **    ** ******** *
*      ******* * ****** ***** *** ** * *
* **** ****  *     **** *****        * *
* ****    **   *** ****       ******   *
* ******* ********      ***********  ***
* *******          ****           **   *
*     *** * ** *** ***** *** ****    ***
* ***     * ** *** ** **     ******* * *
******* *** **           ***      ** * *
**          ***** ***** ********* ** * *
** **** ***       *****           **   *
****************************************